22 19 16 16
#f=floor.png
#w=wall.png
#m=marker.png
#map
w....................w
w....................w
w....................w
w....................w
w....................w
w....................w
w....................w
w................m...w
wfffffffffffffffff...w
w....................w
w....................w
w....................w
w...m................w
w...fffffffffffffffffw
w....................w
w....................w
w....................w
w................m...w
ffffffffffffffffff...f